..........................................
..........................................
..........................................
.......######...........G............X....
..G..............G...................--...
####..G.G.G.G....###......................
.......G.G.GCG............................
......--------............................
...--...........--........................
..........................................
.G.G............G.G.......................
####............####......................
..........................................
.1........................................
##########################################
